
1pp=One Pixel Productions               │                │                    │             │
1pp_hq_music_BGT=1PP High quality music for BGT      │                │                    │             │
1pp_hq_music_II=1PP High quality music for SoA/ToB  │                │                    │             │
1pp_hq_music_ToSC=1PP High quality music for Tutu/ToSC│                │                    │             │
cliffkey=A Mod for the Orderly               │ new items      │ easy               │             │
c#sb_silber=Adalon's Blood                      │ small quest    │ easy               │             │
adrian=Adrian                              │ new NPC        │ not voiced         │             │
aip=Adventures in Papperland            │ NPC banter     │                    │ fun mod     │
Aeon=Aeon                                │ new NPC        │                    │ beta        │
BG1Aerie=Aerie in BG:EE                      │ NPC banter     │                    │             │
DjinniCompanion=Afaaq, the Djinni Companion         │ companions     │                    │             │
AjantisBG1=Ajantis BG1 Expansion               │ NPC banter     │ not voiced         │             │
AjantisBG2=Ajantis BG2                         │ continuing NPC │ not voiced         │ adult       │
AjocMod=Ajoc's Minimod                      │ medium quest   │ standard           │             │
AlabasterSands=Alabaster Sands                          │ medium quest   │ easy               │             │
alassa=Alassa                              │ One Day NPC    │                    │             │
alcool=Alcool                              │ NPC banter     │                    │             │
AM=Alex Macintosh                      │ new items      │ overpowered        │             │
allison=Allison NPC                         │ One Day NPC    │ not ToB            │             │
Almaquest2=Almateria's Quest 2                 │ small quest    │ easy               │             │
Animus=Animus                              │ new items      │ easy               │             │
arestorationp=Almateria's Restoration Project     │ restoration    │                    │             │
alora=Alora NPC                           │ new NPC        │                    │             │
alternatives=Alternatives                        │ gameplay tweak │                    │             │
Amber=Amber                               │ new NPC        │ not ToB            │             │
Angelo=Angelo                              │ continuing NPC │                    │             │
AnimalCompanions=Animal Companions                   │ kit tweak      │                    │             │
anishai=Anishai                             │ One Day NPC    │ not voiced/not ToB │             │
aranw=Aran Whitehand                      │ new NPC        │                    │ beta        │
arath=Arath                               │ new NPC        │ not voiced         │             │
ArcaneArcher=Arcane Archer                       │ new kit        │                    │             │
Area_Patcher=Area Patcher                        │                │                    │             │
Ariena=Ariena                              │ new NPC        │                    │             │
Armiger=Armiger Kit                         │ new kit        │                    │             │
HouseTweaks=Artemius' House Tweaks              │                │                    │             │
ACBre=Ascalons Breagar                    │ new NPC        │                    │             │
AC_QUEST=Ascalons Questpack                  │ medium quest   │ standard           │             │
Ascension=Ascension                           │ medium quest   │ hard               │             │
AsharNPC=Ashar NPC                           │ new NPC        │ not ToB            │             │
ashesofembers=Ashes of Embers                     │ various tweaks │                    │             │
Askaria=Askaria                             │ new NPC        │ not voiced         │             │
Assassinations=Assassinations                      │ medium quest   │ standard           │             │
astScriptPatcher=astScriptPatcher                    │                │                    │             │
aTweaks=aTweaks                             │ various tweaks │                    │             │
ThOghma=Au service d'Oghma                  │ small quest    │                    │             │
Auden=Auden                               │ new NPC        │ not ToB            │             │
AurenAseph=Auren Aseph                         │ new NPC        │                    │             │
A4Auror=Auror Kit                           │ new kit        │                    │             │
aurora=Aurora                              │ new NPC        │                    │             │
tobaurora=Aurora ToB                          │                │                    │             │
fairydragon=Authentic mischiefous Fairy Dragon  │ companions     │                    │             │
AVIM=Avi Maya Project                    │ new NPC        │                    │             │
AzenMOD=Azengaard Tactical Encounter        │ tactic mod     │                    │             │
Azure=Azure NPC                           │ new NPC        │ not voiced/not ToB │ buggy       │
BackBrynnlaw=Back to Brynnlaw                    │ medium quest   │ standard           │             │
bagbonus=Bag Bonus                           │ new items      │ easy               │             │
bgt=Baldur's Gate Trilogy               │                │                    │             │
bst=Balduran's Seatower                 │ medium quest   │ standard           │             │
BDToBv175=Baldurdash                          │ restoration    │                    │             │
bg1re=Baldur's Gate Romantic Encounters   │ NPC banter     │ not voiced         │ adult       │
BanterPack=Banter Pack                         │ NPC banter     │ not voiced         │             │
BardSong_BG2_IWD=Bard Song Switching                 │ IWD tweak      │                    │             │
BBQUIVC=BB's Ammunition Belt                │ new items      │ easy               │             │
BBQUIVB=BB's Bolt Quiver                    │ new items      │ easy               │             │
BBBKBG=BB's Book Bag                       │ new items      │ easy               │             │
BBPBAG=BB's Potion Bag                     │ new items      │ easy               │             │
BBQUIV=BB's Quiver                         │ new items      │ easy               │             │
BBSCARDR=BB's Scimitar of the Arch-Druid     │ new items      │ easy               │             │
BBSCCS=BB's Scroll Case                    │ new items      │ easy               │             │
Bear_Animations_D2=Bear and Werebear animations        │                │                    │             │
BTL=Beyond the Law                      │ new NPC        │                    │             │
bgqe=BG1 Mini Quests and Encounters      │ medium quest   │ easy               │             │
bg1npcbeg=BG1 NPCs at Beginning               │ convenience tweak                   │             │
BG1NPCSoA=BG1 NPCs for BG2:SoA                │ NPC banter     │                    │             │
bg1ub=BG1 Unfinished Business             │ restoration    │                    │             │
BG1NPCMusic=BG1NPC Music Pack                   │                │                    │             │
bg1npc=BG1NPC Project                      │ NPC banter     │                    │ adult       │
bg2fixpack=BG2 Fixpack                         │                │                    │             │
bg2improvedgui=BG2 Improved GUI                    │                │                    │             │
BG2SoA=BG2 Shadows of Amn Item Import      │ new items      │ easy               │             │
Traduccion_Mejorada=BG2 Traduccion Mejorada             │                │                    │             │
BGSpawn=BGSpawn System                      │ gameplay tweak │ tactic mod         │             │
bggoEET=Baldur's Gate Graphics Overhaul for EET              │                    │             │
NSCPortraits=BGT NSC Portraits                   │ portrait       │                    │             │
BGT-NPCSound=BGT-NPCSound-WeiDU                  │                │                    │             │
BGTTweak=BGT Tweakpack BGTTweak              │ various tweaks │                    │             │
BIDDE=Biddekelorak                        │ new NPC        │                    │             │
BP=Big Picture                         │ various tweaks │                    │             │
x0black=Blackguard Fighter                  │ new kit        │                    │             │
BloodMort=Blood Of The Martyr                 │ new items      │ easy               │             │
BoM=Boards of Magick Item Pack          │ new items      │ easy               │             │
bolsa=Bolsa                               │ item tweak     │ easy               │             │
BonsBrucev2=Bons Bruce The Cockney Barfighter   │ One Day NPC    │ not ToB            │             │
bpseries=BP Series                           │ Scripts        │                    │             │
BP-BGT-Worldmap=BP_BGT_Worldmap                     │                │                    │             │
BP-Balancer=BP-Balancer                         │ XP tweak       │                    │             │
c#brage=Brage's Redemption                  │ medium quest   │ easy               │             │
c#brandock=Brandock                            │ new NPC        │                    │             │
Branwen=Branwen BG2 NPC                     │ continuing NPC │                    │             │
BranwenNPC=BranwenNPC                          │ continuing NPC │                    │             │
btweak=BTweaks                             │ item tweak     │                    │             │
btweak_lite=BTweaks Light                       │ item tweak     │                    │             │
BuTcHeRy=BuTcHeRy                            │ tactic mod     │                    │             │
cal=Cal-Culator                         │ small quest    │                    │ buggy       │
Calin=Calin                               │ new NPC        │ not ToB            │             │
cassius=Cassius                             │ One Day NPC    │ not ToB            │             │
FamiliarPack=cbisson's FamiliarPack              │ companions     │                    │ buggy       │
Cerberus=Cerberus                            │ companions     │                    │             │
cernd=Cernd Friendship                    │ NPC banter     │                    │             │
Px_Chantelame=Chantelame                          │ new kit        │                    │             │
ChanterKit=Chanter Kit                         │ new kit        │                    │             │
ChaosKnight=Chaos Knight kit                    │ new NPC        │ not voiced         │             │
Charli=Charli                              │ item tweak     │ easy               │             │
CtB=Check the Bodies                    │ large quest    │                    │             │
CtB_FF=Check the Bodies_Fast Forward       │                │                    │             │
Chiara=Chiara                              │ new NPC        │                    │             │
Chloe=Chloe                               │ new NPC        │                    │             │
cliffhistory=CliffHistory                        │ small quest    │                    │             │
ClubOfPain=Club Of Pain                        │ new items      │ easy               │             │
Cws=Cloakwood Squares                   │ NPC banter     │ not voiced         │ fun mod     │
com_encounters=CoM Encounters                      │ tactic mod     │                    │             │
Conductor=Conductor Kit                       │ new kit        │                    │             │
Coondred=Coondred                            │ new NPC        │                    │             │
Coran=Coran BG2 NPC                       │ continuing NPC │                    │             │
coranbgfriend=Coran's Extended Friendship Talks   │ NPC banter     │ not voiced         │             │
celestiales=Corrections to celestial creatures  │ correction     │                    │             │
corthalaromantique=Corthala Romantique                 │ NPC banter     │                    │             │
crefixer=Creature Fixer                      │                │                    │             │
Cre_Patcher=Creature Patcher                    │                │                    │             │
CritterParts_v1.1=Critter Parts                       │ new items      │ easy               │             │
CrossmodBG2=Crossmod Banter Pack for BG II      │ NPC banter     │                    │             │
Crusade=Crusader Pack                       │ new kit        │                    │             │
cursed_items=Cursed Items Revision               │ item tweak     │                    │             │
A7-CustomKits=Custom Kits: The Spellsword         │ new kit        │                    │             │
imnesvale=D's Odd Quest Mod ^(Imnesvale^)       │ tactic mod     │                    │             │
dace=Dace                                │ new NPC        │                    │             │
darian=Darian                              │ new NPC        │ not voiced         │             │
DarkHorizons=Dark Horizons                       │ large quest    │ hard               │             │
DSotSC=Dark Side of the Sword Coast        │ large quest    │ standard           │             │
Tidings=Dark Tidings                        │ medium quest   │ easy               │             │
DARRON=Darron                              │ item tweak     │ easy               │             │
pcvamp=Dawn of Vampirism                   │ kit tweak      │                    │             │
deArnise=de'Arnise Romance                   │ NPC banter     │ not ToB            │             │
DSoA=Deeper Shadows of Amn               │ tactic mod     │                    │             │
wmart=Deidre and Joluv in BGT             │ new items      │ easy               │             │
Derats_kits=Derat's Unused Kits Pack            │ new kit        │                    │             │
d2ama=Diablo2 Kit Pack - The Amazon       │ new kit        │                    │ incongruous │
d2asn=Diablo2 Kit Pack - The Assassin     │ new kit        │                    │ incongruous │
d2bar=Diablo2 Kit Pack - The Barbaian     │ new kit        │                    │ incongruous │
d2nec=Diablo2 Kit Pack - The Necromancer  │ new kit        │                    │ incongruous │
d2pal=Diablo2 Kit Pack - The Paladin      │ new kit        │                    │ incongruous │
DiffTweak=Difficulty and Tweaks Mod           │ various tweaks │                    │             │
xpmod=Ding0's Experience Fixer            │ XP tweak       │                    │             │
d0questpack=Ding0's QuestPack                   │ AI tweak       │                    │             │
d0tweak=Ding0's Tweak Pack                  │ Correction     │                    │             │
Divine_Remix=Divine Remix                        │ HLA tweak      │                    │             │
DofD=Domains of Dread                    │ tactic mod     │                    │             │
DragonSummon=Dragon Summon                       │ new spells     │ easy               │             │
DrizztIsNotStupid=Drizzt Is Not Stupid                │ gameplay tweak │                    │             │
drizztsaga=Drizzt Saga                         │ large quest    │ hard               │             │
Drows=Drows                               │ gameplay tweak │                    │             │
druidgrovemakeover=Druid Grove Area Makeover           │                │                    │             │
phord_druidkits=Druid Kit Enhancements              │ kit tweak      │                    │             │
DruidicSorcererKit=Druidic Sorcerer Kit                │ new kit        │                    │             │
DungeonBeGone=Dungeon Be Gone                     │ convenience tweak                   │             │
DC=Dungeon Crawl                       │ medium quest   │ standard           │             │
EdwinRomance=Edwin Romance                       │ NPC banter     │                    │             │
EET_Tweaks=EET Tweaks                          │ various tweaks │                    │             │
Eilistraee=Eilistraee's Song                   │ medium quest   │ standard           │             │
Eldoth=Eldoth                              │ new NPC        │ not voiced/not ToB │             │
acidelem_beta1=Elementalist Kits                   │ new kit        │                    │             │
Elvan-all=Elvanshalee                         │ new NPC        │ not ToB            │ buggy       │
elven_pack=Elven Racial Package                │ new kit        │                    │             │
c#endlessbg1=Endless BG1                         │                │                    │             │
Ebg2=Enhanced BG2                        │ new items      │ easy               │             │
eportraits=Enkida's Portrait Pack              │ portrait       │                    │             │
sovereign=Er'vonyrah                          │ medium quest   │ standard           │             │
evandra=Evandra                             │ new NPC        │                    │             │
emad=Every Mod and Dog                   │ medium quest   │ standard           │             │
Exnem=Exnem Vault                         │ new items      │ overpowered        │ incongruous │
GBThfKp=Expanded Thief Stronghold           │ medium quest   │ standard           │             │
JanQuest=Extension de la quete de Jan        │ NPC banter     │                    │             │
Fade=Fade SoA                            │ new NPC        │ not ToB            │             │
fadingpromises=Fading Promises                     │ small quest    │ standard           │             │
Faren=Faren                               │ new NPC        │ not ToB            │             │
FotD=The Fields of the Dead              │ rule tweak     │                    │             │
FinchNPC=Finch                               │ new NPC        │                    │             │
BGII-Subrace=FinnJO's Subrace mod                │ new kit        │                    │             │
FishingForTrouble=Fishing for Trouble                 │ medium quest   │ standard           │             │
mwyvmtan=Fixed Tanar'ri and Wyvern           │                │                    │             │
foodmod=Food and Herbal Mod                 │ new items      │ easy               │             │
FR_ROV=Freedom's Reign/Reign of Virtue     │ new items      │ easy               │             │
frennedan=Frennedan                           │ new NPC        │ not voiced/not ToB │             │
Foundling=Foundling: Between the Shades       │ medium quest   │ standard           │             │
fullplate=Full Plate and Packing Steel        │ rule tweak     │                    │             │
Gahesh=Gahesh                              │ new NPC        │                    │             │
nogameover=Game Over Only on Party Dead        │ convenience tweak                   │             │
garrick-tt=Garrick - Tales of a Troubadour     │ NPC banter     │ not voiced         │             │
garrick_flirt=Garrick's Infatuation               │ NPC banter     │ not voiced         │             │
gavin=Gavin                               │ new NPC        │                    │ adult       │
gavin_bg2=Gavin for BG2                       │ new NPC        │                    │             │
generalized_biffing=Generalized Biffing                 │                │                    │             │
ggib_tweaks=Ggib Eht Tweak Pack                 │ NPC banter     │                    │ adult       │
Haendlermod=Genwa's Haendlermod                 │ new items      │ easy               │             │
druidsor=Geomantic_Sorcerer                  │ new kit        │                    │             │
GRoA=Getting Rid of Anomen               │ NPC banter     │                    │             │
Ghareth=Ghareth                             │ One Day NPC    │                    │             │
ghost=Ghost                               │ new spells     │                    │             │
G3Anniversary=Gibberlings Three Anniversary       │                │                    │ fun mod     │
GlamNPCPack=Glam's NPC Pack                     │ new NPC        │ not voiced         │             │
gloran=Gloran                              │ new NPC        │ not ToB            │             │
gMinion=gMinionScripts                      │ scripts        │                    │             │
Goo=Goo the Disembodied Floating Eyeball│ new NPC        │ not ToB            │             │
c#greythedog=Grey the Dog                        │ new NPC        │ not ToB            │             │
Grimuars=Grimuars                            │ new spells     │                    │             │
haerdalis_friendship=Haer'Dalis Friendship               │ NPC banter     │                    │             │
haerdalisromance=Haer'Dalis Romance                  │ NPC banter     │                    │             │
swordap=Haer'Dalis' Swords                  │ new items      │ easy               │             │
Haiass=Haiass                              │ companions     │                    │             │
haldamir=Haldamir                            │ new NPC        │ not ToB            │             │
Hanna=Hanna                               │ new NPC        │                    │             │
HardTimes=HardTimes                           │ tactic mod     │                    │             │
HarpScout=Harper Scout Kit                    │ new kit        │                    │             │
HeartWood=Heart Of The Wood                   │ new items      │ easy               │             │
HeartwarderKit=Heartwarder of Sune Kit             │ new kit        │                    │             │
Helarine_BGEE=Helarine                            │ new NPC        │                    │             │
BW_Herbs=Herbs and Potions Add-in for BG 1   │ new items      │ standard           │             │
BW_Herbs_BG2=Herbs and Potions Add-in for BG 2   │ new items      │ standard           │             │
HerThiMoney=Heroes, Thieves and Moneylenders    │ medium quest   │ easy               │             │
HessaNPC=Hessa                               │ One Day NPC    │                    │             │
hiddenadventure=Hidden Adventures                   │ small quest    │ easy               │             │
HideKt=Hidden Kits                         │ new kit        │                    │             │
AvengerKit=Holy Avenger                        │ new kit        │                    │             │
homewardbound=Homeward Bound                      │ gameplay tweak │                    │             │
Horace=Horace                              │ new NPC        │ not ToB            │             │
DR8_hotfix=Hotfix for Divine Remix v8          │                │                    │             │
Houyi=Houyi - high-quality archery store  │ new items      │ easy               │             │
Hubelpot=Hubelpot the Vegetable Merchant     │ new NPC        │                    │             │
Huple_NPC=Huple                               │ new NPC        │ not voiced         │             │
c#husam=Husam                               │ new NPC        │                    │             │
ISNF=I Shall Never Forget                │ small quest    │ standard           │             │
iepbanters=IEP Extended Banter                 │ NPC banter     │ not voiced         │             │
Contest=igi's Facing the Shade Lord again   │ small quest    │                    │             │
iiItemMod=igi's Item Mod                      │ new items      │                    │             │
iiKeyNames=igi's Key Names                     │ item tweak     │                    │             │
iiLearnThroughuse=igi's Learn Through Use             │ gameplay tweak │                    │             │
iiProjectileR=igi's Projectile Retrieval Mod      │ gameplay tweak │                    │             │
iiSpellSystemAdjustments=igi's Spell System Adjustments      │ spell tweak    │                    │             │
imoen_forever=Imoen Forever                       │ medium quest   │ standard           │             │
imoenfriendship=Imoen Friendship                    │ NPC banter     │ not voiced         │             │
imoenRomance=Imoen Romance                       │ NPC banter     │ not voiced         │             │
ImoenIsStone=Imoen is Stone                      │                │                    │             │
Vagrant=Improved Anvil Lite                 │ new kit        │                    │             │
impasylum=Improved Asylum                     │ tactic mod     │                    │             │
ValHorn=Improved Horns of Valhalla          │ new items      │ standard           │             │
ImprovedSummons=Improved Summons                    │ gameplay tweak │                    │             │
Volcano=Improved Volcano Pack               │ tactic mod     │                    │             │
IndiNPC=Indira                              │ new NPC        │ not voiced         │             │
infinityanimations=Infinity Animations                 │                │                    │             │
IK=InfinityKits                        │ new kit        │                    │             │
BInfinitySounds=Infinity Sounds                     │                │                    │             │
Innershade=Innershade                          │ medium quest   │ standard           │             │
isra=Isra                                │ NPC banter     │                    │             │
isra_bg2=Isra for BGII                       │ continuing NPC │                    │             │
Item_Pack=Item Pack by Daulmakan              │ new items      │                    │             │
Item_Patcher=Item Patcher                        │                │                    │             │
randomiser=Item Randomiser                     │ Item tweak     │                    │             │
item_rev=Item Revisions                      │ item tweak     │                    │             │
iwditempack=IWD Item Pack                       │ new items      │ standard           │             │
iwdification=IWDification                        │ IWD tweak      │                    │ beta        │
iylos=Iylos                               │ new NPC        │                    │             │
d2item=Jamella's Diablo2 Item Store        │ new items      │                    │ incongruous │
Alchemy=Jan's Alchemy                       │ new items      │ easy               │             │
Jandor=Jandor                              │ new NPC        │ not voiced/not ToB │             │
JA#BGT_AdvPack=Jarls BGT Adventure Pack            │ small quest    │                    │             │
JA#BGT_Tweak=Jarls BGT Tweak Pack                │ various tweaks │                    │             │
JCBruce=JC’s Bruce The Cockney Barfighter   │ One Day NPC    │ not ToB            │             │
Jedi_Sith=Jedi and Sith Kits                  │ new kit        │                    │ incongruous │
jimfix=Jimfix                              │                │                    │             │
JKits=JKits                               │ new kit        │                    │             │
JondalarFix=Jondalar Fix for BGT                │                │                    │             │
BWL_Contest=K'aeloree's BWL Contest Items       │ small quest    │                    │             │
Kari=Kari                                │ new NPC        │                    │             │
Storm=Keenmarker                          │ new kit        │                    │             │
7C-Yoshi=Keeping Yoshimo                     │ NPC banter     │ not voiced         │             │
Keldornv101=Vlad and Senka's Keldorn Romance    │ NPC banter     │ not voiced         │             │
keldorn_rom=berelinde's Keldorn Romance         │ NPC banter     │ not voiced         │             │
Kelsey=Kelsey                              │ new NPC        │                    │             │
Keto=Keto                                │ new NPC        │ not ToB            │             │
Khalid=Khalid BGII                         │ continuing NPC │                    │             │
Kiara-Zaiya=Kiara-Zaiya                         │ new NPC        │                    │ adult       │
Kido=Kido                                │ new NPC        │                    │             │
KWolf=Killing Wolf                        │ new items      │ easy               │             │
KimNPC=Kim                                 │ new NPC        │ not ToB            │             │
Kindrek=Kindrek                             │ new NPC        │                    │             │
kittomes=Kit Tomes                           │ kit tweak      │                    │             │
kitanya=Kitanya SoA                         │ new NPC        │ not ToB            │             │
Kivan=Kivan and Deheriana Companions      │ continuing NPC │                    │             │
klatu=klatu Tweaks and Fixes              │ various tweaks │                    │             │
KKits=Knights Kits                        │ new kit        │                    │             │
KKitNPC=Knights Kits Addon                  │ kit tweak      │                    │             │
KonTwk=Konalan's Tweaks                    │ rule tweak     │                    │             │
Korgan=Korgan's Redemption                 │ NPC banter     │ not voiced         │             │
KorganFriendship=Korgan Friendship                   │ NPC banter     │ not voiced         │             │
ktweaks=Ktweaks                             │ new items      │                    │             │
Derats_Ogre=L'ogre et le gnome                  │ small quest    │ easy               │             │
LaValygar=La'Valygar                          │ NPC banter     │ not voiced         │             │
ViconiaRevamped=Viconia Revamped                    │ NPC tweak      │                    │             │
TutuGUI=LadeJarl's Tutu GUI                 │                │                    │             │
Larsha=Larsha                              │ new NPC        │ not voiced         │             │
LavaIt=LavaIt                              │ new items      │ easy               │             │
LOHMod=Legion of Hell                      │ new kit        │                    │             │
Lena=Lena                                │ new NPC        │ not voiced         │             │
Devin=Les Exiles de Lunargent             │ medium quest   │ standard           │             │
Lester=Lester                              │ new NPC        │ not voiced         │             │
level1npcs=Level 1 NPCs                        │ kit tweak      │                    │             │
7c#addlevel=Level Adder                         │ kit tweak      │                    │             │
zulu=Lion Warrior Kit                    │ new kit        │                    │             │
RezMod=Lol's RezMod                        │ small quest    │                    │             │
lolfixer=Lolfixer                            │                │                    │             │
SpellPackB6=Lost Crossroads Spell Pack          │ spell tweak    │ standard           │             │
LostItems=Lost Items                          │ new items      │ standard           │             │
lucy=Lucy the Wyvern                     │ small quest    │ easy               │             │
LuvNalia=LuvNalia                            │ NPC banter     │ not ToB            │ buggy       │
lyric=Lyric Bard Kit                      │ new kit        │                    │             │
NMR-HAPPY=Macholy's Happy Patch               │ gameplay tweak │                    │             │
NML=Macholy's Living Mod                │ gameplay tweak │                    │             │
NMT=Macholy's Nameless Melody Inn       │ medium quest   │ standard           │             │
NMR=Macholy's Relationship for BGT      │ gameplay tweak │                    │             │
NMRF-PC=Macholy's Teammates fight scripts   │ scripts        │                    │             │
NMTP=Macholy's Tweak Pack                │ gameplay tweak │                    │             │
mih_eq=Made in Heaven: Encounters and Quests medium quest   │ easy               │             │
mih_ip=Made in Heaven: Item Pack           │ new items      │ easy               │             │
Malthis=Malthis                             │ new NPC        │                    │             │
Margarita=Margarita Zelleod                   │ NPC banter     │                    │             │
MawgulNPC=Mawgul                              │ new NPC        │ not voiced/not ToB │             │
mazzy=Mazzy Friendship                    │ NPC banter     │ not voiced         │             │
MegaModKits=MegaModKits                         │ new kit        │                    │             │
MerskStore=Mersetek                            │ new items      │ easy               │             │
Mhoram=Mhoram                              │ new NPC        │ not voiced         │             │
might_and_guile=Might and Guile                     │ various tweaks │                    │             │
MinscFriendship=Minsc Friendship                    │ NPC banter     │                    │             │
FoxMonster=Moddie                              │ new NPC        │ not ToB            │             │
ianinja=Moinesse Ninja Fix                  │                │                    │             │
MDX=Mordan's Christmas Minimod          │ small quest    │                    │ fun mod     │
morituri=Morituri Kit                        │ new kit        │                    │             │
Mortis=Mortis                              │ kit tweak      │                    │ experienced │
MulgoreXaviaNPC=Mulgore and Xavia NPC               │ new NPC        │ not voiced         │             │
multistronghold=Multistronghold                     │ gameplay tweak │                    │             │
MunchMod=Munchmod                            │ new items      │ standard           │             │
mur'neth=Mur'Neth                            │ new NPC        │ not voiced         │             │
musica=Music of the Realms                 │ new items      │ easy               │             │
Mystigan=Mystigan                            │ new items      │ easy               │             │
nanstein=Nanstein                            │ item tweak     │ easy               │             │
Nathaniel=Nathaniel                           │ new NPC        │                    │             │
Neh'taniel=Neh'taniel                          │ new NPC        │ not ToB            │             │
nephele=Nephele                             │ new NPC        │ not voiced         │             │
NeJ3v71=Never Ending Journey v3             │ large quest    │ hard               │ experienced │
BG_Travel=New travel system between BG City   │                │                    │             │
Nikita=Nikita                              │ new NPC        │ not ToB            │             │
Ninde=Ninde                               │ new NPC        │ not voiced         │             │
NTotSC=Northern Tales of the Sword Coast   │ large quest    │ standard           │             │
NTotSCv171=Northern Tales of the Sword Coast Patch              │                    │             │
npckit=NPC Kitpack                         │ kit tweak      │                    │             │
npc_tweak=NPC Tweak                           │ kit tweak      │ standard           │             │
NPCFlirt=NPC Flirt Pack                      │ NPC banter     │ not voiced         │ adult       │
npc_ee=NPCs Enhanced for Everyone          │ kit tweak      │                    │             │
npc_strongholds=NPC Strongholds                     │ gameplay tweak │                    │             │
DKDrizzt=Octavian's Drizzt                   │ new NPC        │ not voiced         │             │
OldModsPack=Old Mods Pack                       │ new items      │ easy               │             │
Ooze=Ooze's Lounge                       │ medium quest   │ easy               │             │
Oversight=Oversight                           │ kit tweak      │                    │             │
Celestials=P and P Celestials                  │ PnP tweak      │                    │             │
P5Tweaks=P5Tweaks                            │ spell tweak    │                    │             │
w_packmule=Pack Mule                           │ companions     │                    │             │
PofKits=Paladins of Faerûn Kitpack          │ new kit        │                    │             │
PoFQuestPack=Paladins of Faerûn Quest Pack       │ medium quest   │ standard           │             │
parting=Parting Ways                        │ convenience tweak                   │             │
POB=Perils of Branwen                   │ continuing NPC │                    │             │
Petsy=Petsy Chattertone                   │ new NPC        │ not ToB            │             │
W_3kradziej=Pickpocket Options                  │ convenience tweak                   │             │
Pirate=Pirate Kit                          │ new kit        │                    │             │
PlanarSphereMod=Planar Sphere                       │ medium quest   │ standard           │             │
freeact=PnP Free Action                     │ item tweak     │                    │             │
polytweak=Polytweak                           │ various tweaks │                    │             │
PPK=Prestige Kitpack                    │ new kit        │                    │             │
PBhaal=PrÍtre de Bhaal                     │ new kit        │                    │             │
w_psionics_unleashed=Psionics Unleashed                  │ rule tweak     │                    │ beta        │
QualloFix=Quallo                              │ small quest    │                    │             │
Quayle=Quayle Project                      │ continuing NPC │ not voiced         │             │
Questor=Questor - Mike's QuestMod           │ small quest    │                    │ buggy       │
Raziel=Raziel                              │ new NPC        │ not ToB            │             │
RotBArmorSet=Realm of the Bhaalspawn Armor Set   │ new items      │ easy               │             │
Recarga=Recarga                             │ new items      │ easy               │             │
refinements=Refinements                         │ HLA tweak      │                    │             │
RoT=Region of Terror                    │ large quest    │ hard               │             │
Renal=Renal                               │ new items      │ easy               │             │
TxtMusic=Restored Prologue Textscreen Music  │                │                    │             │
dw_lanthorn=Restored Rhynn Lanthorn Quest       │ small quest    │                    │             │
RetaliatorKit=Retaliator Kit                      │ new kit        │                    │             │
Reunion=Reunion                             │ medium quest   │ easy               │             │
RevisedBattles=Revised Battles                     │ tactic mod     │                    │             │
RFWIP=Revised Forgotten Wars Item Pack    │ new items      │ easy               │             │
RGenie=Ribald's Genie                      │ new items      │ easy               │             │
RItemPack=RItemPack                           │ new items      │ standard           │             │
Rjali=Rjali                               │ new NPC        │                    │             │
Roar=Roar                                │ new NPC        │ not voiced/not ToB │             │
RR=Rogue ReBalancing by aVENGER        │ various tweaks │                    │             │
rogue-switch=RogueSwitch                         │ new kit        │                    │             │
Rolles=Rolles                              │ new items      │ easy               │             │
RE=Romantic Encounters                 │ NPC banter     │ not voiced         │ adult       │
rose=Rose NPC for BGT                    │ continuing NPC │ not voiced/not ToB │ beta        │
RPG-KP=RPG Dungeon Kit Pack                │ new kit        │                    │             │
rttitempack=RTT Item Pack                       │ new items      │ easy               │             │
kitrtt=RTT Kit Pack                        │ new kit        │                    │             │
Ruad=Ruad Ro'fessa Item Upgrade          │ new items      │ easy               │             │
fr_ombre=RÙdeur de l'ombre                   │ new kit        │                    │             │
rukrakia=Rukrakia                            │ new NPC        │                    │             │
run=Rune Singer Blades                  │ new kit        │                    │             │
rupert=Rupert the Dye Merchant             │ new items      │ easy               │             │
Rylorn=Rylorn                              │ new NPC        │                    │ buggy       │
Saerileth=Saerileth                           │ new NPC        │                    │             │
SamuraiKit=Samurai Kit                         │ new kit        │                    │             │
SandrahItem=SandrahNPC Item Restauration        │ correction     │                    │             │
SandrahNPC=Sandrah NPC                         │ new NPC        │                    │             │
SandrahRTF=Sandrah - Return to Faerûn          │ large quest    │                    │             │
SandrahTOT=Sandrah - Times of Trouble          │ small quest    │                    │             │
saradas_magic=Saradas Magic                       │ new items      │ easy               │             │
saradas_magic_2=Saradas Magic 2                     │ new items      │ easy               │             │
sarahtob=Sarah ToB                           │ new NPC        │                    │ adult       │
sarevokfriendship=Sarevok Friendship                  │ NPC banter     │ not voiced         │             │
sarevokromance=Sarevok Romance                     │ NPC banter     │                    │             │
sarerestore=Sarevok Recovery                    │ restoration    │                    │             │
7c#sartweak=Sarevok-related tweaks              │ kit tweak      │ standard           │             │
scales_of_balance=Scales of Balance                   │ various tweaks │                    │             │
ScionMod=Scion of Murder                     │ new kit        │                    │             │
BoneHillv275=Secret of Bonehill                  │ large quest    │ standard           │             │
semi_multi_clerics=Semi-Multi-Clerics                  │ kit tweak      │ standard           │             │
Severian=Severian de Demerya                 │ new NPC        │                    │             │
SOS=Shadows Over Soubar                 │ large quest    │ hard               │ experienced │
sharteel=Shar-Teel                           │ continuing NPC │                    │             │
ShardsOfIce=Shards of Ice                       │ small quest    │                    │             │
SDMODS=Shed's Mods                         │ small quest    │ easy               │             │
Sheena=Sheena                              │ new NPC        │ not voiced/not ToB │             │
sigil-bd-mod=Sigil's Birthday Mod                │ new items      │                    │ incongruous │
Star=Silverstar                          │ new NPC        │ not voiced/not ToB │             │
Kitpack6=Six's Kitpack                       │ new kit        │                    │             │
Skie=Skie                                │ continuing NPC │                    │             │
SkipChateauIrenicus=Skip Chateau Irenicus               │ convenience tweak                   │             │
SkooterTheNPC=Skooter the NPC                     │ NPC banter     │                    │ fun mod     │
slandor=Slandor - The Minotaur and Lilacor  │ small quest    │ easy               │             │
SmilingImpCrossBanterMod=Smiling Imp's Cross Banter Mod      │ NPC banter     │                    │             │
rpgsolaflirtpack=Solaufein Flirt Pack                │ NPC banter     │                    │             │
Solaufein=Solaufein NPC                       │ new NPC        │ not voiced         │             │
c#solaufein=Solaufeins Rettung                  │                │                    │             │
abSolestia=Solestia                            │ new NPC        │ not voiced/not ToB │             │
song_and_silence=Song and Silence                    │ PnP tweak      │                    │             │
spstuff=Sorcerer's Place Collection         │ new items      │ easy               │             │
SouthernEdge=Southern Edge                       │ medium quest   │ easy               │             │
spitems=SP Items                            │ new spells     │ standard           │             │
SPItemPack=SP Items                            │ new spells     │ standard           │             │
spell_rev=Spell Revisions                     │ spell tweak    │ standard           │             │
Spell50=Spell-50                            │ spell tweak    │ standard           │             │
spgaunt=Spellhold Gauntlet                  │ small quest    │ standard           │             │
stivan=Stivan                              │ NPC banter     │ not voiced         │ beta        │
StuffofTheMagi=Stuff of the Magi                   │ new items      │ standard           │             │
SBS=Summon Bhaalspawn                   │ new NPC        │                    │             │
Firkraag=Super Firkraag Mod                  │ tactic mod     │                    │             │
sword_and_fist=Sword and Fist                      │ PnPTweak       │                    │             │
mapnames=Sword Coast Map Labels              │                │                    │             │
stratagems=Sword Coast Stratagems              │ various tweaks │                    │             │
Swylif=Swylif Thicc                        │ small quest    │ easy               │             │
1Sylm=Sylmar Battlefield                  │ small quest    │ hard               │             │
Tactics=Tactics                             │ tactic mod     │                    │ experienced │
ToA=Tales of Anegh                      │ large quest    │ standard           │             │
TotDG=Tales of the Deep Gardens           │ medium quest   │ standard           │             │
Tashia=Tashia Remix                        │ new NPC        │                    │             │
BGeeAR=TeamBG Armor Pack for BG1           │ new items      │ standard           │             │
BG2eeAR=TeamBG Armor Pack for BG2           │ new items      │ standard           │             │
BGeeW=TeamBG Weapon Pack for BG1          │ new items      │ standard           │             │
BG2eeW=TeamBG Weapon Pack for BG2          │ new items      │ standard           │             │
Teddy=Teddy                               │ new NPC        │ not voiced/not ToB │             │
Teleport=Teleport                            │ new spells     │ standard           │             │
Tempest=Tempest KitMod                      │ new kit        │                    │             │
TenyaThermidor=Tenya Thermidor                     │ medium quest   │ easy               │             │
TethyrForestPatch=Tethyr Forest Patch                 │                │                    │             │
TP=Textpatch für BG2                   │                │                    │             │
Thael=Thael                               │ new NPC        │                    │             │
thalan=Thalantyr Item Upgrade Mod          │ new items      │ standard           │             │
Arena=The Arena Project                   │ tactic mod     │                    │             │
BearWalker=The Bear Walker                     │ new kit        │                    │             │
TheBeaurinLegacy=The Beaurin Legacy                  │ new NPC        │                    │             │
tb#kits=The Bigg Kit Pack                   │ new kit        │                    │             │
tb#quest=The Bigg Quest Pack                 │ tactic mod     │                    │ adult       │
tb#tweaks=The Bigg Tweak Pack                 │ various tweaks │                    │             │
BWQuest=The Black Rose I: Market Prices     │ medium quest   │ standard           │             │
BridgesBlock=The Bridge's Block                       │ medium quest   │ easy               │             │
thecalling=The Calling                         │ restoration    │                    │             │
TDD=The Darkest Day                     │ large quest    │ hard               │             │
TGC1E=The Grey Clan I: In Candlelight     │ medium quest   │ standard           │             │
hf_HHG=The Holy Hand Grenade               │ small quest    │                    │ fun mod     │
JZ=The Jerry Zinger Show               │ NPC banter     │ not voiced         │ fun mod     │
LongerRoad=The Longer Road                     │                │ standard           │             │
SirinesCall=The Lure of the Sirine's Call       │ medium quest   │ standard           │             │
LuxleySoA=The Luxley Family                   │ new NPC        │ not ToB            │             │
Tzshop01=The Magnificient Magic Shop         │ new items      │ easy               │             │
MTS_Crappack=The MTS Crappack                    │ various tweaks │                    │             │
The_Old_Gold=The Old Gold                        │ new items      │ easy               │             │
THEONEDRIZZT=The One Drizzt                      │                │                    │             │
portablehole=The Portable Hole                   │ new items      │ easy               │             │
Sellswords=The Sellswords                      │ medium quest   │ standard           │             │
SilverFur=The Silver Fur of Sel°ne            │ new kit        │                    │             │
SNAKES=The Slithering Menace               │ small quest    │                    │             │
SOA=The Stone of Askavar                │ medium quest   │ standard           │             │
TangledIsle=The Tangled Oak Isle                     │ medium quest   │ easy               │             │
cdtweaks=The Tweaks Anthology                │ various tweaks │                    │             │
TheUndying=The Undying                         │ small quest    │ standard           │             │
vault=The Vault                           │ tactic mod     │                    │             │
wheels=The Wheels of Prophecy              │ gameplay tweak │                    │             │
WhiteQueen=The White Queen                     │ medium quest   │ standard           │             │
TobEx=Throne of Bhaal Extender            │                │                    │             │
tobr=Throne of Bhaal Revisited           │ gameplay tweak │                    │             │
hammers=Thrown Hammers                      │ item tweak     │                    │             │
karatur=T'was a Slow Boat from Kara-Tur     │ small quest    │ easy               │             │
Tiax=Tiax                                │ continuing NPC │                    │             │
DNT=Tomoyo and the underground city     │ tactic mod     │                    │             │
TTSQ=Tortured Soul Quest                 │ medium quest   │ standard           │             │
TS=Tortured Souls                      │ large quest    │ hard               │             │
touched=Touchstone                          │ new NPC        │                    │             │
TOD=Tower Of Deception                  │ medium quest   │ standard           │ tactic      │
tooltipfix=tooltipfix                          │                │                    │             │
trap_rev=Trap Revisions                      │ gameplay tweak │                    │             │
trovador=Trovador                            │ new items      │ easy               │             │
ts25mini=TS25MiniMod                         │ small quest    │ standard           │             │
Tsujatha=Tsujatha                            │ new NPC        │                    │ adult       │
TsukiBG2=Tsuki for BG2                       │ continuing NPC │                    │ adult       │
Turambar_fixes_tweaks=Turambar's fixes and tweaks         │ various tweaks │                    │             │
Turnabout=Turnabout                           │                │                    │             │
TurnipGolem=Turnip Golem                        │ small quest    │ easy               │             │
tnt=Tweaks and Tricks                   │ various tweaks │                    │             │
TyrisFlare=Tyris Flare                         │ new NPC        │ not voiced         │             │
Uldar=Uldar                               │ new NPC        │                    │             │
sagaman=Ulrien of Cormyr: SagaMaster        │ small quest    │ easy               │             │
ua=Unique Artifacts                    │ item tweak     │                    │             │
UoT=Umbra of T.R.O.W.                   │ tactic mod     │                    │             │
Underrep=Underrepresented Items              │ new items      │ easy               │             │
UB=Unfinished Business for BGII        │ restoration    │                    │             │
dsr=Unholy Gate Opening Ritual Book     │ new spells     │ tactic mod         │             │
UniqueArtifacts=Unique Artifacts                    │ item tweak     │                    │             │
contain=Unique Containers                   │ correction     │                    │             │
UCFOW=Universal Clear Fog of War          │ convenience tweak                   │             │
AbyStore=Unusual Oddities Shop ^(AbyStore^)    │ new items      │ easy               │             │
Valen=Valen                               │ new NPC        │ not voiced         │             │
valerie=Valerie                             │ new NPC        │ not voiced         │             │
ValygarFriendship=Valygar Friendship                  │ NPC banter     │                    │             │
VampireTales=Vampire Tales                       │ new NPC        │                    │             │
Vanim=Vanim                               │ new NPC        │ not voiced/not ToB │             │
Varshoon=Varshoon                            │ new NPC        │                    │             │
vecna=Vecna                               │ large quest    │ hard               │             │
Vendedor_DLAN=Vendedor DLAN                       │ new items      │ easy               │             │
viconia=Viconia Friendship                  │ NPC banter     │ not voiced         │             │
Vic=Victor's Improvements Pack          │ kit tweak      │ standard           │             │
Vildra=Vildra                              │ new NPC        │ not voiced/not ToB │             │
Virtue=Virtue                              │ rule tweak     │                    │             │
VCv21=Vlads Compilation                   │ large quest    │ hard               │ experienced │
VolcanicArmoury=Volcanic Armoury                    │ new items      │ easy               │             │
vynd=Vynd                                │ new NPC        │                    │             │
W_GUI=W_GUI beta                          │                │                    │             │
WandCase=Wand Case                           │ new items      │ easy               │             │
WarslingSniperKit=Warsling Sniper Kit                 │ new kit        │                    │             │
WBGTAP=Wedges BGT Adventure Pack           │ small quest    │ easy               │             │
ItemUpgrade=Weimer's Item Upgrade               │ new items      │ standard           │             │
werewarrior=Werewarrior Fighter Kit             │ new kit        │                    │             │
white=White                               │ new NPC        │                    │             │
widescreen=Widescreen Mod                      │                │                    │             │
Wikaede=Wikaede                             │ new NPC        │                    │             │
WildMage=Wild Mage Additions                 │ new spells     │ standard           │             │
WillyB=Willie Bruce                        │ new NPC        │ not ToB            │             │
wsr=Wizard Slayer Rebalancing           │ various tweaks │                    │             │
worgas=Worgas                              │ new NPC        │                    │             │
WTPFamiliars=WTP Familiars for Throne of Bhaal   │ companions     │                    │             │
Xan=Xan BG2                             │ continuing NPC │                    │             │
XanBG2Voice=Xan's BG2 voice for BG1             │                │                    │             │
XanBG1Friend=Xan's friendship path for BG1       │ NPC banter     │ not voiced         │             │
xulaye=Xulaye                              │ new NPC        │ not voiced/not ToB │             │
Yasraena=Yasraena                            │ new NPC        │ not ToB            │             │
yeslicknpc=Yeslick                             │ NPC banter     │ not ToB            │             │
Yikari=Yikari                              │ new NPC        │ not voiced         │             │
YLITEMS=YLItems                             │ new items      │ easy               │             │
yoshimo=Yoshimo Friendship                  │ NPC banter     │ not voiced         │             │
YoshimosRemorse=Yoshimo's Remorse                   │ NPC banter     │                    │             │
YoshimoRomance=Yoshimo Romance                     │ NPC banter     │                    │             │
Yvette=Yvette Romance                      │ new NPC        │                    │             │
Zalnoya=Zalnoya and the Shadow Thieves      │ small quest    │ easy               │             │
Z#Misc=Zyraen's Miscellaneous Mods         │ various tweaks │                    │             │
Zakrion_BG1=Zakrion                             │ new NPC        │                    │             │
ZELINK=ZELINK                              │ medium quest   │ standard           │             │
ZFA=Zum Freundlichen Arm                │ convenience tweak                   │             │
